40 20
13
442 110 447 122 859 880 1624 1630 2360 2053 2372 2365 1207
319 511 703 895 959 767 703 895 895 703 511 127 319
5 5 5 5 5 5 5 5 5 5 5 5 5 5 5 5 5 5 5 5 5 5 5 5 5 5 5 5 5 5 5 5 5 5 5 5 5 5 5 5 
5 5 5 5 5 5 5 5 5 5 5 5 9 5 5 5 5 5 5 5 5 5 5 5 5 5 5 9 5 5 5 5 5 5 5 5 5 5 5 5 
5 9 9 0 5 5 5 5 5 5 5 5 5 5 9 9 9 5 5 5 5 5 9 9 9 5 5 5 5 5 5 5 5 5 5 0 9 9 9 5 
5 5 5 5 5 5 5 5 5 5 5 5 5 5 5 5 5 5 5 9 5 5 5 5 5 5 5 5 5 5 5 5 5 5 5 5 5 5 5 5 
5 5 5 5 5 5 5 5 5 5 5 5 5 5 5 5 5 5 5 5 5 5 5 5 5 5 5 5 5 3 5 1 5 5 5 5 5 9 5 5 
5 5 9 5 5 0 9 9 9 5 5 5 0 9 9 9 9 0 9 9 9 0 9 9 9 9 9 0 5 5 9 9 9 0 9 5 5 5 5 5
5 5 5 5 5 5 5 5 5 5 5 5 5 5 5 5 5 5 5 5 5 5 5 5 5 5 5 5 5 3 5 5 5 5 5 5 5 5 5 5 
5 5 5 5 5 5 5 5 5 5 5 5 5 5 5 5 5 5 5 5 5 5 5 5 5 5 5 5 5 5 5 5 5 5 5 5 5 5 5 5 
5 9 9 9 0 5 5 5 5 5 4 4 4 4 4 4 4 4 4 4 4 4 4 4 4 4 4 4 4 4 5 5 9 5 5 0 9 9 9 5 
5 5 5 5 5 5 9 5 5 5 5 5 5 5 5 5 5 5 5 5 5 5 5 5 5 5 5 5 5 5 5 5 5 5 5 5 5 5 5 5 
5 5 5 5 5 5 5 5 5 5 5 5 5 5 5 5 5 5 5 9 9 5 5 5 5 5 5 5 5 5 5 5 5 5 5 5 5 5 5 5 
5 5 9 5 5 0 9 9 9 5 5 5 5 5 5 5 5 5 5 5 5 5 5 5 0 9 9 0 5 5 5 9 9 9 0 5 5 9 5 5 
5 5 5 5 5 5 5 5 5 5 5 5 0 9 9 0 5 5 5 5 5 5 5 5 5 5 5 5 5 5 5 5 5 5 5 5 5 5 5 5 
5 5 5 5 5 5 5 5 5 5 5 5 5 5 5 5 5 5 0 9 9 0 5 5 5 5 5 5 5 5 5 5 5 5 5 5 5 5 5 5 
5 9 9 9 0 5 5 5 5 5 5 5 5 5 5 5 5 5 5 5 5 5 5 5 0 9 9 0 5 5 5 5 5 5 5 0 9 9 9 5 
5 5 5 5 5 5 5 5 5 5 5 5 0 9 9 0 5 5 5 5 5 5 5 5 5 5 5 5 5 5 5 5 5 5 5 5 5 5 5 5 
5 5 5 5 5 5 9 5 3 5 1 5 5 5 5 5 5 5 0 9 9 0 5 5 5 5 5 5 5 3 5 1 5 5 9 5 5 5 5 5 
5 5 5 5 5 5 5 5 5 9 5 5 5 5 5 5 5 5 5 5 5 5 5 5 5 5 5 5 5 5 9 5 5 5 5 5 5 5 5 5 
5 4 4 4 4 4 4 4 4 5 4 4 4 4 4 4 4 4 4 4 4 4 4 4 4 4 4 4 4 4 5 4 4 4 4 4 4 4 4 5 
5 5 5 5 5 5 5 5 5 5 5 5 5 5 5 5 5 5 5 5 5 5 5 5 5 5 5 5 5 5 5 5 5 5 5 5 5 5 5 5 

