40 20
48 900
66 66 66 66 66 66 66 66 66 66 66 66 66 66 66 66 66 66 66 66 66 66 66 66 66 66 66 66 66 66 66 66 66 66 66 66 66 66 66 66
66 49 50 45 45 45 66 28 28 28 28 28 28 28 28 28 28 28 28 28 28 28 28 28 28 28 28 28 28 28 28 30 28 66 45 45 45 45 45 66 
66 45 45 45 45 66 28 28 28 28 28 28 28 28 28 28 28 28 28 28 29 29 29 28 28 28 28 28 28 28 28 30 28 28 66 45 45 50 45 66 
66 45 54 55 66 28 28 28 28 28 28 28 28 28 28 28 28 28 28 29 29 28 28 28 28 28 28 28 28 28 28 30 28 28 28 66 45 55 45 66 
66 45 45 45 66 28 28 28 28 28 34 67 67 67 67 67 34 28 28 28 28 28 28 28 34 67 34 67 34 28 28 30 28 29 29 66 54 55 45 66 
66 45 45 66 28 28 28 29 29 28 13 28 28 30 28 30 28 28 28 28 28 28 28 28 28 28 28 6 28 28 28 30 28 28 28 28 66 45 45 66 
66 45 66 28 28 28 28 28 29 29 8 28 28 30 28 30 28 28 28 32 67 32 28 28 28 28 28 1 28 28 28 30 28 28 28 28 28 66 45 66 
66 66 28 28 28 33 33 28 28 28 8 28 28 31 28 31 28 28 28 28 6 28 28 28 28 28 28 28 28 28 28 30 32 34 32 28 28 28 66 66 
66 28 28 28 28 28 28 28 28 28 28 28 28 31 28 31 28 28 28 28 1 28 29 28 28 28 67 67 67 67 28 30 30 30 20 28 28 28 28 66 
66 28 28 28 28 28 28 28 28 28 28 28 28 30 28 31 28 28 28 28 28 29 29 28 28 28 28 28 28 28 28 30 30 30 15 28 28 28 28 66
66 28 28 28 28 28 32 67 67 67 67 67 32 30 28 30 67 67 67 67 29 29 28 28 28 28 28 28 28 28 28 30 30 30 15 28 28 28 28 66
66 28 29 28 28 28 6 30 30 28 28 28 28 30 28 30 20 30 28 28 28 28 28 28 28 28 28 29 29 28 28 30 30 30 30 67 67 67 67 66 
66 28 29 29 28 28 1 30 30 28 28 28 28 30 28 30 15 30 28 28 28 28 28 28 28 28 28 28 28 28 28 30 30 31 30 28 28 28 28 66 
66 28 28 28 28 28 28 30 30 28 29 29 28 30 67 30 15 30 28 28 28 28 36 32 28 28 28 28 28 28 28 30 31 31 30 28 28 28 28 66 
66 28 28 28 28 28 28 30 30 28 28 29 29 30 20 30 30 30 28 28 28 28 30 20 29 29 36 67 67 67 32 30 30 31 30 28 28 28 28 66 
66 67 67 67 67 67 67 30 30 28 28 28 28 30 15 30 31 31 34 67 67 34 30 22 29 28 30 30 30 30 30 30 30 30 30 28 28 28 28 66 
66 30 30 31 31 31 30 30 30 67 67 67 67 30 30 31 31 30 30 30 30 30 30 22 28 28 30 31 31 31 30 30 30 30 30 28 28 28 28 66 
66 30 30 30 30 31 30 30 30 30 66 66 30 30 31 31 30 30 30 30 30 30 30 30 67 67 30 30 30 31 31 30 30 30 30 67 67 67 67 66 
66 30 30 30 30 30 30 30 30 30 66 66 30 30 30 30 30 30 30 30 30 30 30 30 66 66 30 30 30 30 30 30 30 30 30 66 66 66 66 66
66 66 66 66 66 66 66 66 66 66 66 66 66 66 66 66 66 66 66 66 66 66 66 66 66 66 66 66 66 66 66 66 66 66 66 66 66 66 66 66 