40 20
106 127
66 66 66 66 66 66 66 66 66 66 66 66 66 66 66 66 66 66 66 66 66 66 66 66 66 66 66 66 66 66 66 66 66 66 66 66 66 66 66 66 
66 28 28 28 28 28 28 28 28 67 30 20 28 29 28 28 29 29 28 28 28 28 28 28 28 29 28 28 30 30 67 28 29 29 28 28 29 29 29 66
66 28 28 28 28 29 29 29 28 67 30 15 34 29 28 28 28 29 29 29 28 28 28 28 28 29 28 34 30 30 67 28 29 28 28 28 29 28 28 66
66 67 67 67 32 28 28 29 28 67 30 15 28 29 67 34 67 28 28 28 28 28 67 34 67 28 28 28 30 30 67 28 29 29 28 32 67 67 67 66
66 28 28 28 28 28 29 29 28 67 30 31 29 29 30 30 30 28 28 34 29 29 30 30 30 28 29 29 30 30 67 28 28 29 29 28 28 13 28 66
66 28 28 28 28 28 28 28 28 67 30 30 28 28 30 30 30 28 28 28 28 28 30 30 30 29 28 29 31 30 28 28 28 28 28 28 28 34 28 66
66 28 34 29 28 32 67 67 67 67 30 30 67 67 30 30 30 67 67 67 67 67 30 30 30 67 67 67 31 30 67 67 67 67 32 28 29 8 28 66
66 28 29 28 28 28 28 6 28 67 30 30 30 30 30 30 30 30 30 30 30 30 30 30 30 31 27 31 30 30 67 28 13 28 28 29 29 28 28 66 
66 28 28 28 28 28 28 1 28 67 67 30 30 30 30 30 30 30 30 30 30 30 30 30 30 30 30 30 30 67 67 28 8 28 28 28 28 28 28 66 
66 67 67 67 32 28 29 28 28 67 67 67 67 67 67 67 67 67 67 67 67 67 67 67 67 67 67 67 67 67 67 28 34 28 28 32 67 67 67 66 
66 28 6 28 28 28 34 29 28 67 67 30 28 28 28 28 30 30 28 28 28 28 30 20 28 28 28 28 30 67 67 28 29 29 28 28 28 28 28 66 
66 28 1 28 28 28 28 28 28 67 30 30 28 28 28 28 30 30 67 34 34 67 30 15 29 28 28 28 30 30 67 28 28 28 28 28 29 29 28 66 
66 28 34 29 28 39 67 67 67 67 30 31 29 28 28 28 30 30 29 28 6 28 30 15 67 67 67 67 30 30 67 67 67 67 39 28 28 34 28 66 
66 28 29 28 28 30 27 30 30 67 30 31 67 67 67 67 30 30 29 28 28 28 30 30 29 28 28 28 30 30 67 30 30 27 31 28 28 28 28 66 
66 28 28 28 28 30 22 30 30 67 30 31 28 6 28 28 30 30 67 67 67 67 30 30 29 28 28 28 30 30 67 30 31 22 30 28 28 28 28 66 
66 67 67 67 39 30 22 31 30 67 30 30 28 28 28 28 30 30 29 28 28 28 30 30 39 67 67 39 30 30 67 30 31 22 30 67 67 67 67 66 
66 30 20 30 30 30 30 31 30 67 30 30 39 67 67 39 30 30 28 28 28 28 30 30 31 30 30 30 30 30 67 30 31 31 30 30 30 30 30 66 
66 30 22 30 30 30 34 30 30 28 30 30 31 31 31 31 30 30 39 67 67 39 30 30 30 31 31 31 31 30 28 30 30 30 34 30 30 31 30 66 
66 30 30 30 30 30 30 30 30 34 30 30 30 30 30 30 30 30 30 30 30 30 30 30 30 30 30 30 30 30 34 30 30 30 30 30 30 30 30 66 
66 66 66 66 66 66 66 66 66 66 66 66 66 66 66 66 66 66 66 66 66 66 66 66 66 66 66 66 66 66 66 66 66 66 66 66 66 66 66 66 