40 20
154 1087
66 66 66 66 66 66 66 66 66 66 66 66 66 66 66 66 66 66 66 66 66 66 66 66 66 66 66 66 66 66 66 66 66 66 66 66 66 66 66 66 
66 28 28 28 28 28 28 30 20 28 28 28 28 28 28 28 28 28 28 28 29 29 28 28 28 28 28 28 28 28 28 28 28 28 28 28 28 29 28 66 
66 28 28 29 29 29 28 30 15 28 29 28 28 28 28 28 28 28 28 29 29 28 28 28 34 28 28 28 28 28 28 28 28 28 34 28 28 29 28 66 
66 28 29 29 28 28 28 30 15 28 29 28 34 67 67 67 67 67 34 28 28 28 28 28 28 28 28 29 29 28 28 28 28 28 28 28 28 29 28 66 
66 28 28 34 34 34 28 30 15 28 29 28 28 28 6 28 28 28 28 28 28 28 28 29 29 29 29 29 28 32 67 67 67 67 67 32 28 29 28 66 
66 28 28 28 28 28 28 30 30 28 28 28 28 28 1 28 34 28 28 28 28 28 28 28 28 28 28 28 28 28 28 30 28 28 6 28 28 28 28 66 
66 28 28 34 28 28 28 31 30 28 28 28 28 28 1 28 28 28 28 28 28 34 67 67 67 67 34 28 29 29 28 30 28 28 1 28 28 28 28 66 
66 28 28 28 28 28 28 31 31 28 28 28 28 28 28 28 28 28 34 28 28 28 28 28 6 28 28 28 28 29 28 30 28 28 28 28 28 28 28 66 
66 28 28 28 28 28 28 31 31 28 28 32 67 67 32 28 28 28 28 28 28 28 28 28 1 28 28 28 28 28 28 30 67 67 67 67 67 67 67 66 
66 67 67 67 67 67 28 30 31 28 28 28 6 28 28 28 28 29 29 28 28 28 67 67 67 67 67 29 29 29 28 30 20 28 28 28 28 28 28 66 
66 28 6 28 28 28 28 30 30 28 28 28 28 28 28 28 28 28 28 28 29 28 30 28 28 28 29 29 28 28 28 30 15 28 28 28 28 28 28 66 
66 28 1 28 29 29 29 30 30 28 28 34 67 67 67 67 67 67 34 28 29 28 30 28 28 28 28 28 28 28 28 30 30 28 28 28 34 28 28 66 
66 28 1 28 28 28 28 30 30 28 28 28 28 30 20 30 28 28 28 28 29 28 30 67 67 67 67 67 67 28 28 30 30 28 28 28 28 28 28 66 
66 28 1 32 67 67 39 30 30 29 28 28 28 30 15 30 28 28 28 28 28 28 30 30 28 28 28 6 28 28 28 30 30 67 67 67 67 67 67 66 
66 28 28 6 28 30 30 30 30 28 28 28 28 30 15 31 29 28 28 34 28 28 30 30 28 28 28 1 28 28 28 31 31 30 28 28 6 28 28 66 
66 28 28 1 28 30 31 30 30 28 28 28 28 30 30 30 28 28 28 28 28 28 30 30 34 67 67 67 67 67 34 30 31 30 28 28 1 28 28 66 
66 28 28 28 28 30 31 30 30 34 67 67 34 30 30 30 28 28 28 28 28 28 30 31 31 66 66 66 66 66 30 30 31 31 28 28 1 28 28 66 
66 28 28 28 28 30 30 30 30 30 66 66 30 30 30 30 34 67 67 67 67 34 31 31 30 30 66 66 66 30 30 30 30 30 28 28 28 28 28 66 
66 67 67 67 67 30 30 30 30 30 66 66 30 30 30 30 30 30 66 66 30 30 31 30 30 30 66 66 66 30 30 30 30 30 67 67 67 67 67 66 
66 66 66 66 66 66 66 66 66 66 66 66 66 66 66 66 66 66 66 66 66 66 66 66 66 66 66 66 66 66 66 66 66 66 66 66 66 66 66 66 