40 20
12
286 670 1186 1822 2293 1607 2186 2144 1490 1528 942 962
767 959 1023 895 767 703 447 191 319 511 639 127
5 5 5 5 5 5 5 5 5 5 5 5 5 5 5 5 5 5 5 5 5 5 5 5 5 5 5 5 5 5 5 5 5 5 5 5 5 5 5 5 
5 5 5 5 5 5 5 5 5 5 5 5 5 5 5 5 5 5 5 5 5 5 5 5 9 5 5 5 5 5 5 5 5 5 9 5 5 5 5 5 
5 5 5 5 5 5 5 5 5 5 5 5 0 9 9 9 9 9 0 5 5 5 5 5 5 5 5 5 5 5 5 5 5 5 5 5 5 5 5 5 
5 5 5 9 0 9 5 5 5 5 5 5 5 5 5 5 5 5 5 5 5 5 5 5 5 5 5 5 5 0 9 9 0 9 9 0 5 5 5 5 
5 5 5 5 5 5 5 5 5 5 5 5 5 5 5 5 9 5 5 5 5 5 5 5 5 5 5 5 5 5 5 5 5 5 5 5 5 5 5 5 
5 5 5 9 5 5 5 5 5 5 5 5 5 5 5 5 5 5 5 5 5 0 9 9 9 9 0 5 5 5 5 5 5 5 5 5 5 5 5 5 
5 5 5 5 5 5 5 5 5 5 5 5 5 5 5 5 5 5 9 5 5 5 5 5 5 5 5 5 5 5 5 5 5 5 5 5 5 5 5 5 
5 5 5 5 5 5 5 5 5 5 5 0 9 9 0 5 5 5 5 5 5 5 5 5 5 5 5 5 5 5 5 5 0 9 9 9 9 0 0 5 
5 9 9 0 0 0 5 5 5 5 5 5 5 5 5 5 5 5 5 5 5 5 0 9 9 9 0 5 5 5 5 5 5 5 5 5 5 5 5 5 
5 5 5 5 5 5 5 5 5 5 5 5 5 5 5 5 5 5 5 5 5 5 5 5 5 5 5 5 5 5 5 5 5 5 5 5 5 5 5 5 
5 5 5 5 5 5 5 5 5 5 5 0 9 9 9 9 9 9 0 5 5 5 5 5 5 5 5 5 5 5 5 5 5 5 5 5 9 5 5 5 
5 5 5 5 5 5 5 5 5 5 5 5 5 5 5 5 5 5 5 5 5 5 5 0 9 9 9 9 0 5 5 5 5 5 5 5 5 5 5 5 
5 5 5 0 9 9 0 5 5 5 5 5 5 5 5 5 5 5 5 5 5 5 5 5 5 5 5 5 5 5 5 5 5 0 9 9 9 9 0 5 
5 5 5 5 5 5 5 5 5 5 5 5 5 5 5 5 5 5 5 9 5 5 5 5 5 5 5 5 5 5 5 5 5 5 5 5 5 5 5 5 
5 5 5 5 5 5 5 5 5 5 5 5 5 5 5 5 5 5 5 5 5 5 5 5 0 9 9 0 9 9 0 5 5 5 5 5 5 5 5 5 
5 5 5 5 5 5 5 5 5 0 9 9 0 5 5 5 5 5 5 5 5 5 5 5 5 5 5 5 5 5 5 5 5 5 5 5 5 5 5 5 
5 5 5 5 5 5 5 5 5 5 5 5 5 5 5 5 0 9 9 9 9 0 5 5 5 5 5 5 5 5 5 5 5 5 5 5 5 5 5 5 
5 0 5 5 0 5 5 5 5 5 5 5 5 5 5 5 5 5 5 5 5 5 5 5 5 5 5 5 5 5 5 5 5 5 0 0 0 9 9 5 
5 5 5 5 5 4 4 4 4 4 5 5 4 4 4 4 4 4 5 5 4 4 4 4 4 4 5 5 5 4 4 4 4 4 5 5 5 5 5 5 
5 5 5 5 5 5 5 5 5 5 5 5 5 5 5 5 5 5 5 5 5 5 5 5 5 5 5 5 5 5 5 5 5 5 5 5 5 5 5 5 